9
5
221111111111111111122
200000000000000000002
100000000000000000001
100000000000000000001
100000000000000000001
100000000000000000001
100000000000000000001
100000000000000000001
100000000000000000001
200000000000000000002
221111110000011111122
200000000000000000002
100000000000000000001
100000000000000000001
100000000000000000001
100000000000000000001
100000000000000000001
100000000000000000001
100000000000000000001
200000000000000000002
221111111111111111122
END
7
5
3
1
