9
10
222221111111111122222
200000000000000000002
200000000000000000002
200000000000000000002
200000000000000000002
100002211111112200001
100002000000000200001
100001000000000100001
100001000000000100001
100001000000000100001
100001000000000100001
100001000000000100001
100001000000000100001
100001000000000100001
100002000000000200001
100002211111112200001
200000000000000000002
200000000000000000002
200000000000000000002
200000000000000000002
222221111111111122222
END
8
5
4
5
